CTTTTTTTTTTTTTTTTTTTTTTTTTTTTTTTTTTTTTTTTTTTTTTTTTTTT
CTTTTTTTTT  TTTTTTTTTTTTTTTTTTTTTTTTTTTTTTTTTTTTTTTTT
CTTTTTTTTT          TTTTTTTTTTTTTTTTTTTTTTTTTTTTTTTTT
CTTTTTTTTTTTTTTTTTTTTTTTTTTTTTTTTTTTTTTTTTTTTTTTTTTTT
CTTTTTTTTTTTTTTTTTTTTTTTTTTTTTTTTTTTTTTTTTTTTTTTTTTTT
CTTTTTTTTTTTTTTTTTTTTTTTTTTTTTTTTTTTTTTTTTTTTTTTTTTTT
C       TT       TTT       TTT       TTTTTTTTTTTTTTTT
C       T         T         T         TTTTTTTTTTTTTTT
CA!     T    T    T    T    T    T    TTTTTTTTTTTTTTT
C       T    T    T    T    T    T    TTTTTTTTTTTTTTT
C       T    T    T    T    T    T    TTTTTTTTTTTTTTT
CA!     T    T    T    T    T    T    TTTTTTTTTTTTTTT
C       T    T    T    T    T    T    TTTTTTTTTTTTTTT
C       T    T    T    T    T    T    TTTTTTTTTTTTTTT
CA!     T    T    T    T    T    T    TTTTTTTTTTTTTTT
C       T    T    T    T    T    T    TTTTTTTTTTTTTTT
C       T    T    T    T    T    T    TTTTTTTTTTTTTTT
CA!     T    T    T    T    T    T    TTTTTTTTTTTTTTT
C       T    T    T    T    T    T    TTTTTTTTTTTTTTT
C       T    T    T    T    T    T    TTTTTTTTTTTTTTT
CA!     T    T    T    T    T    T    TTTTTTTTTTTTTTT
C            T         T         T    TTTTTTTTTTTTTTT
C           TTT       TTT       TT    TTTTTTTTTTTTTTT
CTTTTTTTTTTTTTTTTTTTTTTTTTTTTTTTTTTTTTTTTTTTTTTTTTTTT
CTTTTTTTTTTTTTTTTTTTTTTTTTTTTTTTTTTTTTTTTTTTTTTTTTTTT
CTTTTTTTTTTTTTTTTTTTTTTTTTTTTTTTTTTTTTTTTTTTTTTTTTTTT
CTTTTTTTTTTTTTTTTTTTTTTTTTTTTTTTTTTTTTTTTTTTTTTTTTTTT
CTTTTTTTTTTTTTTTTTTTTTTTTTTTTTTTTTTTTTTTTTTTTTTTTTTTT
