CTTTTTTTTTTTTTTTTTTTTTTT
CTTTTTTTTT  TTTTTTTTTTTT
CTTTTTTTTT          TTTT
CTTTTTTTTTTTTTTTTTTTTTTT
CTTTTTTTTTTTTTTTTTTTTTTT
CTTTTTTTTTTTTTTTTTTTTTTT
C        TTTTTTTTTTTTTTT
CA!     TTTTTTTTTTTTTTTT
C        TTTTTTTTTTTTTTT
CTTTTTTT TTTTTTTTTTTTTTT
C        TTTTTTTTTTTTTTT
CA!     TTTTTTTTTTTTTTTT
C        TTTTTTTTTTTTTTT
CTTTTTTT TTTTTTTTTTTTTTT
C        TTTTTTTTTTTTTTT
CA!     TTTTTTTTTTTTTTTT
C        TTTTTTTTTTTTTTT
CTTTTTTT TTTTTTTTTTTTTTT
C        TTTTTTTTTTTTTTT
CA!     TTTTTTTTTTTTTTTT
C        TTTTTTTTTTTTTTT
CTTTTTTT TTTTTTTTTTTTTTT
C        TTTTTTTTTTTTTTT
CA!     TTTTTTTTTTTTTTTT
C        TTTTTTTTTTTTTTT
CTTTTTTT TTTTTTTTTTTTTTT
C        TTTTTTTTTTTTTTT
CA!     TTTTTTTTTTTTTTTT
C        TTTTTTTTTTTTTTT
CTTTTTTT TTTTTTTTTTTTTTT
C        TTTTTTTTTTTTTTT
CA!     TTTTTTTTTTTTTTTT
C        TTTTTTTTTTTTTTT
CTTTTTTT TTTTTTTTTTTTTTT
C        TTTTTTTTTTTTTTT
CA!     TTTTTTTTTTTTTTTT
C        TTTTTTTTTTTTTTT
CTTTTTTT TTTTTTTTTTTTTTT
C        TTTTTTTTTTTTTTT
CA!     TTTTTTTTTTTTTTTT
C        TTTTTTTTTTTTTTT
CTTTTTTT TTTTTTTTTTTTTTT
C        TTTTTTTTTTTTTTT
CA!     TTTTTTTTTTTTTTTT
C        TTTTTTTTTTTTTTT
CTTTTTTT TTTTTTTTTTTTTTT
C        TTTTTTTTTTTTTTT
CA!     TTTTTTTTTTTTTTTT
C        TTTTTTTTTTTTTTT
CTTTTTTT TTTTTTTTTTTTTTT
C        TTTTTTTTTTTTTTT
CA!     TTTTTTTTTTTTTTTT
C        TTTTTTTTTTTTTTT
CTTTTTTT TTTTTTTTTTTTTTT
C        TTTTTTTTTTTTTTT
CA!     TTTTTTTTTTTTTTTT
C        TTTTTTTTTTTTTTT
CTTTTTTT TTTTTTTTTTTTTTT
C        TTTTTTTTTTTTTTT
CA!     TTTTTTTTTTTTTTTT
C        TTTTTTTTTTTTTTT
CTTTTTTT TTTTTTTTTTTTTTT
C        TTTTTTTTTTTTTTT
CA!     TTTTTTTTTTTTTTTT
C        TTTTTTTTTTTTTTT
CTTTTTTT TTTTTTTTTTTTTTT
C        TTTTTTTTTTTTTTT
CA!     TTTTTTTTTTTTTTTT
C        TTTTTTTTTTTTTTT
CTTTTTTT TTTTTTTTTTTTTTT
C        TTTTTTTTTTTTTTT
CA!     TTTTTTTTTTTTTTTT
C        TTTTTTTTTTTTTTT
CTTTTTTT TTTTTTTTTTTTTTT
C        TTTTTTTTTTTTTTT
CA!     TTTTTTTTTTTTTTTT
C        TTTTTTTTTTTTTTT
CTTTTTTT TTTTTTTTTTTTTTT
C        TTTTTTTTTTTTTTT
CA!     TTTTTTTTTTTTTTTT
C        TTTTTTTTTTTTTTT
CTTTTTTT TTTTTTTTTTTTTTT
C        TTTTTTTTTTTTTTT
CA!     TTTTTTTTTTTTTTTT
C        TTTTTTTTTTTTTTT
CTTTTTTT TTTTTTTTTTTTTTT
CTTTTTTTTTTTTTTTTTTTTTTT
CTTTTTTTTTTTTTTTTTTTTTTT
CTTTTTTTTTTTTTTTTTTTTTTT
CTTTTTTTTTTTTTTTTTTTTTTT
CTTTTTTTTTTTTTTTTTTTTTTT
